163,163,163,163,163,163,163,163,163,163,163,163,163,163,176,177,177,177,177,177,177,177,177,177,177,177,177,177,177,177
163,160,161,162,163,163,163,163,163,163,163,163,163,163,176,177,6,7,7,7,7,7,7,7,7,7,7,7,8,177
163,176,177,178,163,163,163,163,163,163,163,163,163,163,176,177,22,23,23,23,23,23,23,23,23,23,23,23,24,177
163,192,193,194,163,163,163,163,163,163,163,163,163,163,176,177,38,39,39,39,39,39,39,39,39,39,23,23,24,177
163,163,163,163,163,163,163,163,163,163,163,163,163,163,176,177,177,177,177,177,177,177,177,177,177,177,22,23,24,177
163,163,163,163,163,163,163,163,163,163,163,163,163,163,192,177,177,177,177,177,177,177,177,177,177,177,22,23,24,177
163,163,163,163,163,163,163,163,163,163,163,163,163,163,163,176,177,177,177,177,177,177,177,177,177,177,22,23,24,177
163,163,163,163,163,163,163,163,163,163,163,163,163,163,163,176,177,177,177,177,177,177,177,177,177,177,25,26,27,177
163,163,163,163,163,163,163,163,163,163,163,163,160,161,161,177,177,177,177,177,177,177,177,177,177,177,25,26,27,177
163,163,163,163,163,163,163,163,163,163,163,163,177,9,10,10,10,10,10,10,10,10,10,10,10,10,26,26,27,177
163,163,163,163,163,163,163,161,161,161,161,177,177,25,26,26,26,26,26,26,26,26,26,26,26,26,26,26,27,177
163,163,163,193,193,177,177,177,177,177,177,177,177,41,25,26,27,42,42,42,42,42,42,42,42,42,26,26,27,177
161,163,163,163,163,193,193,193,193,177,177,177,177,177,25,26,27,177,177,177,177,177,177,177,177,177,41,42,43,177
178,163,163,163,163,163,163,163,163,177,177,177,177,177,25,26,27,177,177,177,177,177,0,1,1,1,1,4,5,177
177,161,161,161,161,161,161,161,161,177,177,177,177,177,25,26,27,177,177,177,177,177,16,17,17,17,17,20,21,177
177,177,177,177,177,177,177,177,177,177,177,177,177,177,25,26,27,177,177,177,177,177,32,33,33,33,17,17,18,177
177,177,177,9,10,10,10,10,10,10,10,10,10,10,57,58,27,177,177,177,177,177,177,177,177,177,16,17,18,177
177,177,177,25,26,26,26,26,26,26,26,26,26,26,73,74,27,177,177,177,177,177,177,177,177,177,16,17,18,177
177,177,177,41,42,42,42,42,42,42,42,42,42,42,41,42,43,177,177,177,177,177,177,177,177,177,32,33,34,177
177,177,177,177,177,177,177,177,177,177,177,177,177,177,177,177,177,177,177,177,177,177,177,177,177,177,177,177,177,177